1111111111111111111111111111111111
1P10E00000011110000000000000001111
1010000000001100001110000001000001
101C0000000100000011111000000010C1
1011111000000000001111100000001111
1001111110000000100011110000001111
1000011100000001100001110000C11111
10000000000000011000C1111001110001
100C000000000011100000111001110101
11000000100000111111111110000000C1
11100000000000001111111000000001C1
10000000000000000000000000000111C1
10000111111110000000000000111111C1
1111111111111111111111111111111111