111111111111111111
1P10E0000000000001
101000000000000001
101C000000000010C1
101111111000001111
101111111000001111
101111111000C01111
100000000001110001
100C00000001110101
1000000000000001C1
1000000000000001C1
1000000000000001C1
1000000000000001C1
111111111111111111