111111111111
1P00001E0001
10000C100001
111111111111