111111111111
1P00000E0001
1000001000C1
111111111111