111111111111
1P000E110001
10000C1000C1
111111111111